6.20
XXXXXXX_XXXXXXXXXXXX
X__________________X
X___________________
X__________________X
X__________________X
XxXXXXXXXXXXXXXXXXXX