6.12
XXXXXXXXXXXX
X__________X
___________X
X___________
X__________X
XXXXXXXXXXXX