10.20
XXXXXXXXXXXXXXXXXXXX
X__________________X
X__________________X
X__________________X
___________________X
X__________________X
X__________________X
X__________________X
X__________________X
XXXXXXX_XXXXXXXXXXXX