20.8
XXXXXXXX
X______X
X______X
_______X
X______X
X______X
X______X
X______X
X______X
X______X
X______X
X______X
X______X
X______X
X______X
X______X
X______X
X______X
X______X
XXXXX_XX