6.9
..XXX_XXX
..X_____X
..X_____X
..X__W__X
..X_____X
..XXXXXXX