7.9
XXXXXXXXX
X_______X
X_______X
X_______X
X________
X_______X
XXXXXXXXX
