7.9
XXXXXXXXX
X_______X
X_______X
X____P__X
X___P_P__
X_______X
XXXXXXXXX
