10.20
XXXXXXXXXXXXXXXXXXXX
X__________________X
X______________E___X
X__________EEEE____X
_______E_____EE__E_X
X__________________X
X____________E_____X
X___________EEEEE__X
X__________________X
XXXXXXX_XXXXXXXXXXXX